##############################
#                            #
#######	     #               #
#                            #
#                    ##      #
#                            #
####                         #
#                            #
#                            #
##############################